00000000000000000000
0xx000000000x000xx00
0xs00000000>00000x00
0xx00xxx00000000xx00
00000x0x000000000000
00000x000f0000000000
000000^0000000000000
0xx000000000v0000000
0x00000<00000x000000
0xx000x0000000000000
00000000000000000000
00000000000000000000
00000000000x0x000000
00000000000xxx000000
00000000000000000000
00000000000000000000
00000000000000000000
00000000000000000000
00000000000000000000
00000000000000000000
